11111111111111111111111111111111111111111111111111
1E000000000000000000000000000000000000000000000001
1000000000000000000C000000000000000000000000000001
10000000000000000000000000000000000000000000000001
1000000000000000000000000000000000C000000000000001
10000000000000001100000000000000000000000100000001
1000000000000000000000000C000000000000000000000001
10000000000000000000000000000000000000000000000001
10000000000001100000000000000000010000000000000001
100000000P0000000000000000000000000000000000000001
10000000000100000000000111100000101110000000000001
100000110000000000000111C0100000000000000000000011
10000000000000000000011101100000000000000000000001
10000000000000000000000011111100000000000000000001
11111111111111111111111111111111111111111111111111